r 19
c 21
*******************
*        *        *
* ** *** * *** ** *
*                 *
* ** * ***** * ** *
*    *   *   *    *
**** *** * *** ****
**** *       * ****
**** * ** ** * ****
  p    *   *       
**** * ***** * ****
**** *       * ****
**** * ***** * ****
*        *        *
* ** *** * *** ** *
*  *           *  *
** * * ***** * * **
*    *   *   * *  *
* ****** * ****** *
*                 *
*******************